|s  |   |     |  * * *| | |
- - - ----- - - - --- - - -
|*| | | |   | |  *  |*    |
- - - - --- - --- --  - ---
|* * *|* *|* * *|*  |*|   |
- - - - - - - - - - - - - -
|   |* *|* *  |* *  |* *  |
- - - - --- - --- --  - ---
|     |   |     |   | |* *|
- - - - - - - - - - - - - -
|   |   |     |     |    t|
---------------------------

