|s *|   |     |* * * *| | |
- - - ----- - - - --- - - -
| |*| | |   | |* *  |* *  |
- - - - --- - --- --  - ---
|  * *|* *|  * *|* *| |* *|
- - - - - - - - - - - - - -
|   |* *|* * *|* * *|    t|
---------------------------