|   |   |     |* * * *| | |
- - - ----- - - - --- - - -
| | | | |   | |* *  |* *  |
- - - - --- - --- --  - ---
|     |* *|     |* *| |* *|
- - - - - - - - - - - - - -
|   |* *|* * *|  * *|* * *|
- - - ----- - --- --  - ---
| |* *|   |  * *|* *|*|   |
- - - --- - - - - - - - - -
|s *|   |     |* * *|* * t|
---------------------------

