|s *|   |     |* * * *| | |
- - - ----- - - - --- - - -
| |*| | |   | |* *  |* *  |
- - - - --- - --- --  - ---
|  * *|   |     |* *| |* *|
- - - - - - - - - - - - - -
|   |* *|     |  * *|* * *|
- - - - --- - --- --  - ---
|     |* *|  * *|* *|*|   |
- - - - - - - - - - - - - -
|   |   |* * *|* * *|* * t|
---------------------------

