|s *|   |     |  * * *| | |
- - - ----- - - - --- - - -
| |*| | |   | |  *  |* *  |
- - - - --- - --- --  - ---
|  * *|* *|  * *|*  | |* *|
- - - - - - - - - - - - - -
|   |* *|* * *|* *  |    t|
---------------------------