|   |   |     |  * * *| | |
- - - ----- - - - --- - - -
| | | | |   | |  *  |*    |
- - - - --- - --- --  - ---
|     |* *|* * *|*  |*|   |
- - - - - - - - - - - - - -
|   |* *|* *  |* *  |* *  |
- - - ----- - --- --  - ---
| |* *|   |     |   | |* *|
- - - --- - - - - - - - - -
|s *|   |     |     |    t|
---------------------------

